NO ./pics/redbrick.xpm
SO ./pics/redbrick.xpm
WE ./pics/redbrick.xpm
EA ./pics/redbrick.xpm

F 189, 154, 46
C 15,202,202


1111
10N1
1111