NO ./pics/redbrick.xpm
SO ./pics/redbrick.xpm
WE ./pics/redbrick.xpm
EA ./pics/redbrick.xpm

F 189, 154, 46
C 15,202,202




        1111111111111111111111111
        1000000000110000000000001
        1011000001110000000000001
        1001000000000000000000001
111111111011000001110000000000001
100000000011000001110111110111111
11110111111111011100000010001
11110111111111011101010010001
11000000110101011100000010001
100100000000000S1100000010001
11010000000000000001010010001
1001000111010101111101111000111
11010111 1110101 101111010001
11111111 1111111 111111111111