NO ./pics/redbrick.xpm
SO ./pics/greystone.xpm 
WE ./pics/redbrick.xpm
EA ./pics/bluestone.xpm

F 189,19, 46

C 15,15,20

11111111111111111   11111
1100000000000001   10001
10000000000000001   10001   
1000000000000000111110001   
1000000000000000000000001    
1000000000000000000000001
1000000000000000000000001
100000000000000000000001
1000000000000000000000001    1111
10000000000S0000000000001    1001
1000000000010000000000001    1111
1000000000000000000000001
1000000000000000000000001
1000000000000000000000001
1000000000000000000000001
100000000000000000000001
1000000000000000000000001
1000000000000000000000001
1000000000000000000000001
11111000000000000000000011111
    1000000000000000000000001
11111000000000000000000011111
1000000000000000000000001
1000000000000000000000001
1111111111111111111111111